####################
## ## ## # ####### #
#       E          F
### #### ###########
######## ###########
#######   ##########
####################